1112222221111222222111122222211112222221
1213333331112224222111122222211112222221
1111112431111222222111122222211112222221
1112222221111222222111122222211112222221
1213333331112224222111122222211112222221
1111112431111222222111122222211112222221
1112222221111222222111122222211112222221
1213333331112224222111122222211112222221
1111112431111222222111122222211112222221
1112222221111222222111122222211112222221
1213333331112224222111122222211112222221
1111112431111222222111122222211112222221
1112222221111222222111122222211112222221
1213333331112224222111122222211112222221
1111112431111222222111122222211112222221
1112222221111222222111122222211112222221
1213333331112224222111122222211112222221
1111112431111222222111122222211112222221
1112222221111222222111122222211112222221
1213333331112224222111122222211112222221
1111112431111222222111122222211112222221
1112222221111222222111122222211112222221
1213333331112224222111122222211112222221
1111112431111222222111122222211112222221
1112222221111222222111122222211112222221
1213333331112224222111122222211112222221
1111112431111222222111122222211112222221
1112222221111222222111122222211112222221
1213333331112224222111122222211112222221
1111112431111222222111122222211112222221